"a" = (/turf/cobblestone,/area)
"b" = (/turf/city/city_wall,/area)
"c" = (/turf/city/city_road,/area)
"d" = (/obj/city/table,/turf/cobblestone,/area)
"e" = (/obj/city/table{step_x = 1; step_y = 1},/turf/cobblestone,/area)
"f" = (/turf/city/city_house_wall,/area)
"g" = (/turf/city/city_house_window,/area)
"h" = (/turf/city/city_gate,/area)
"i" = (/turf/city/city_wall,/area/city/Marnid)
"j" = (/turf/cobblestone,/area/city/Marnid)
"k" = (/turf/city/city_house_wall,/area/city/Marnid)
"l" = (/turf/city/city_floor,/area/city/Marnid)
"m" = (/turf/city/city_house_window,/area/city/Marnid)
"n" = (/turf/city/city_road,/area/city/Marnid)
"o" = (/turf/city/city_gate,/area/city/Marnid)

(1,1,1) = {"
aaaaaaaaaaaaaaaaaaaaaaaaaaaaaaaaaaaaaaaaaaaaaaaaaaaaaaaaaaaaaaaaaaaaaa
aaaaaaaaaaaaaaaaaaaaaaaaaaaaaaaaaaaaaaaaaaaaaaaaaaaaaaaaaaaaaaaaaaaaaa
aaaaaaaaaaaaaaaaaaaaaaaaaaaaaaaaaaaaaaaaaaaaaaaaaaaaaaaaaaaaaaaaaaaaaa
aaaaaaaaaaaaaaaaaaaaaaaaaaaaaaaaaaaaaaaaaaaaaaaaaaaaaaaaaaaaaaaaaaaaaa
aaaaaaaaaaaaaaaaaaaaaaaaaaaaaaaaaaaaaaaaaaaaaaaaaaaaaaaaaaaaaaaaaaaaaa
aaaaaaaaaaaaaaaaaaaaaaaaaaaaaaaaaaaaaaaaaaaaaaaaaaaaaaaaaaaaaaaaaaaaaa
aaaaaaaaaaaaaaaaaaaaaaaaaaaaaaaaaaaaaaaaaaaaaaaaaaaaaaaaaaaaaaaaaaaaaa
aaaaaaaaaaaaaaaaaaaaaaaaaaaaaaaaaaaaaaaaaaaaaaaaaaaaaaaaaaaaaaaaaaaaaa
aaaaaaaaaaaaaaaaaaaaaaaaaaaaaaaaaaaaaaaaaaaaaaaaaaaaaaaaaaaaaaaaaaaaaa
aaaaaaaaaaaaaaaaaaaaaaaaaaaaaaaaaaaaaaaaaaaaaaaaaaaaaaaaaaaaaaaaaaaaaa
aaaaaaaaaaaaaaaaaaaaaaaaaaaaaaaaaaaaaaaaaaaaaaaaaaaaaaaaaaaaaaaaaaaaaa
aaaaaaaaaaaaaaaaaaaaaaaaaaaaaaaaaaaaaaaaaaaaaaaaaaaaaaaaaaaaaaaaaaaaaa
aaaaaaaaaaaaaaaaaaaaaaaaaaaaaaaaaaaaaaaaaaaaaaaaaaaaaaaaaaaaaaaaaaaaaa
aaaaaaaaaaaaaaaaaaaaaaaaaaaaaaaaaaaaaaaaaaaaaaaaaaaaaaaaaaaaaaaaaaaaaa
aaaaaaaaaaaaaaaaaaaaaaaaaaaaaaaaaaaaaaaaaaaaaaaaaaaaaaaaaaaaaaaaaaaaaa
aaaaaaaaaaaaaaaaaaaaaaaaaaaaaaaaaaaaaaaaaaaaaaaaaaaaaaaaaaaaaaaaaaaaaa
aaaaaaaaaaaaaaaaaaaaaaaaaaaaaaaaaaaaaaaaaaaaaaaaaaaaaaaaaaaaaaaaaaaaaa
aaaaaaaaaaaaaaaaaaaaaaaaaaaaaaaaaaaaaaaaaaaaaaaaaaaaaaaaaaaaaaaaaaaaaa
aaaaaaaaaaaaaaaaaaaaaaaaaaaaaaaaaaaaaaaaaaaaaaaaaaaaaaaaaaaaaaaaaaaaaa
aaaaaaaaaaaaaaaaaaaaaaaaaaaaaaaaaaaaaaaaaaaaaaaaaaaaaaaaaaaaaaaaaaaaaa
aaaaaaaaaaaaaaaaaaaaaaaaaaaaaaaaaaaaaaaaaaaaaaaaaaaaaaaaaaaaaaaaaaaaaa
aaaaaaaaaaaaaaaaaaaaaaaaaaaaaaaaaaaaaaaaaaaaaaaaaaaaaaaaaaaaaaaaaaaaaa
aaaaaaaaaaaaaaaaaaaaaaaaaaaaaaaaaaaaaaaaaaaaaaaaaaaaaaaaaaaaaaaaaaaaaa
aaaaaaaaaaaaaaaaaaaaaaaaaaaaaaaaaaaaaaaaaaaaaaaaaaaaaaaaaaaaaaaaaaaaaa
aaaaaaaaaaaaaaaaaaaaaaaaaaaaaaaaaaaaaaaaaaaaaaaaaaaaaaaaaaaaaaaaaaaaaa
aaaaaaaaaaaaaaaaaaaaaaaaaaaaaaaaaaaaaaaaaaaaaaaaaaaaaaaaaaaaaaaaaaaaaa
aaaaaaaaaaaaaaaaaaaaaaaaaaaaaaaaaaaaaaaaaaaaaaaaaaaaaaaaaaaaaaaaaaaaaa
aaaaaaaaaaaaaaaaaaaaaaaaaaaaaaaaaaaaaaaaaaaaaaaaaaaaaaaaaaaaaaaaaaaaaa
aaaaaaaaaaaaaaaaaaaaaaaaaaaaaaaaaaaaaaaaaaaaaaaaaaaaaaaaaaaaaaaaaaaaaa
aaaaaaaaaaaaaaaaaaaaaaaaaaaaaaaaaaaaaaaaaaaaaaaaaaaaaaaaaaaaaaaaaaaaaa
aaaaaaaaaaaaaaaaaaaaaaaaaaaaaaaaaaaaaaaaaaaaaaaaaaaaaaaaaaaaaaaaaaaaaa
aaaaaaaaaaaaaaaaaaaaaaaaaaaaaaaaaaaaaaaaaaaaaaaaaaaaaaaaaaaaaaaaaaaaaa
bbbbbbbbbbbbbbbbbbbbbbbbbbbbbbbbbbbbbbaaaaaaaaaaaaaaaaaaaaaaaaaaaaaaaa
baaaaaaaaaaaaaaaaaaaaaaaaaaaaaaaaaaaabaaaaaaaaaaaaaaaaaaaaaaaaaaaaaaaa
baaaaaaaaaaaaaaaaaaaaaaaaacccccccccdabaaaaaaaaaaaaaaaaaaaaaaaaaaaaaaaa
baaaaaaaaaaaaaaaaaaaaaaaaaccccccccceabaaaaaaaaaaaaaaaaaaaaaaaaaaaaaaaa
baaaaaaaaaaaaaaaaaaaaaaaaaccaaaaaaabbbaaaaaaaaaaaaaaaaaaaaaaaaaaaaaaaa
baaaaaaaaaaaaaaaaaaaaaaaaaccaaaaaaabaaaaaaaaaaaaaaaaaaaaaaaaaaaaaaaaaa
baaaaaaaaaaaaaaaaaaaaaaaaaccaaaaaaabaaaaaaaaaaaaaaaaaaaaaaaaaaaaaaaaaa
baaaaaaaaaaaaaaaaaaaaaaaaaccaaaaaaabaaaaaaaaaaaaaaaaaaaaaaaaaaaaaaaaaa
baaaaaaaaaaaaaaaaaaaaaaaaaccaaaaaaabaaaaaaaaaaaaaaaaaaaaaaaaaaaaaaaaaa
baaaaaaaaaaaaaaaaaaaaaaaaaccaaaaaaabaaaaaaaaaaaaaaaaaaaaaaaaaaaaaaaaaa
baaaaaaaaaaaaaaaaaaaaaaaaaccaaaaaaabaaaaaaaaaaaaaaaaaaaaaaaaaaaaaaaaaa
baaaaaaaaaaaaaaaaaaaaaaaaaccfffffffbaaaaaaaaaaaaaaaaaaaaaaaaaaaaaaaaaa
baaaaaaaaaaaaaaaaaaaaaaaaaccfaaaaafbaaaaaaaaaaaaaaaaaaaaaaaaaaaaaaaaaa
baaaaaaaaaaaaaaaaaaaaaaaacccfaaaaafbaaaaaaaaaaaaaaaaaaaaaaaaaaaaaaaaaa
baaaaaaaaaaaaaaaaaaaccccccccgaaaaafbaaaaaaaaaaaaaaaaaaaaaaaaaaaaaaaaaa
baaaaaaaaaaaaaaaaaaccccccccccaaaaafbaaaaaaaaaaaaaaaaaaaaaaaaaaaaaaaaaa
baaaaaaaaaaaaaaaaaccccaaaaaagaaaaafbaaaaaaaaaaaaaaaaaaaaaaaaaaaaaaaaaa
baaaaaaaaaaaaaaaaccccaaaaaaafaaaaafbaaaaaaaaaaaaaaaaaaaaaaaaaaaaaaaaaa
bcccccccccccccccccccaaaaaaaafffffffbaaaaaaaaaaaaaaaaaaaaaaaaaaaaaaaaaa
hccccccccccccccccccaaaaaaaaaaaaaaaabaaaaaaaaaaaaaaaaaaaaaaaaaaaaaaaaaa
iiiiiiiiiiiiiiiiiiiiiiiiiiiiiiiiiiiiaaaaaaaaaaaaaaaaaaaaaaaaaaaaaaaaaa
ijjkkkkkkkjjjjjkkkkkkkkkjkkkkkkkkkkiaaaaaaaaaaaaaaaaaaaaaaaaaaaaaaaaaa
ijjklllllkjjjjjklllllllkjkllllllllkiaaaaaaaaaaaaaaaaaaaaaaaaaaaaaaaaaa
ijjmlllllmjjjjjmlllllllkjkllllllllkiaaaaaaaaaaaaaaaaaaaaaaaaaaaaaaaaaa
ijjklllllkjjjjjklllllllmjmllllllllkiaaaaaaaaaaaaaaaaaaaaaaaaaaaaaaaaaa
ijjmlllllkjjjjjklllllllkjkllllllllkiaaaaaaaaaaaaaaaaaaaaaaaaaaaaaaaaaa
ijjkllllllnnnnnllllllllkjkllllllllkiaaaaaaaaaaaaaaaaaaaaaaaaaaaaaaaaaa
ijjkkmkmkkjnnnjkkmkmkmkkjkkmkmklkmkiaaaaaaaaaaaaaaaaaaaaaaaaaaaaaaaaaa
iiiijjjjjjjnnjjjjjjjjjjjjjjjjjnnnjjiaaaaaaaaaaaaaaaaaaaaaaaaaaaaaaaaaa
iiijjjjjjjjnnjjjjjjjjjjjjjjjjjnnniiiaaaaaaaaaaaaaaaaaaaaaaaaaaaaaaaaaa
iiijjjjjjjjnnjjjjjjjjjjjjjjjjjnnniiiaaaaaaaaaaaaaaaaaaaaaaaaaaaaaaaaaa
iiiijjjjjjjnnjjjjjjjjjjjjjjjjjnnnjiiaaaaaaaaaaaaaaaaaaaaaaaaaaaaaaaaaa
innnnnnnnnnnnnnnnnnnnnnnnnnnnnnnnjjiaaaaaaaaaaaaaaaaaaaaaaaaaaaaaaaaaa
onnnnnnnnnnnnnnnnnnnnnnnnnnnnnnnnjiiaaaaaaaaaaaaaaaaaaaaaaaaaaaaaaaaaa
iiiijjjjjjjjjjjjjjjjjjjjjjjjjjjjjjjiaaaaaaaaaaaaaaaaaaaaaaaaaaaaaaaaaa
iiiijjjjjjjjjjiiiijjjjjiiiiijjjjjiiiaaaaaaaaaaaaaaaaaaaaaaaaaaaaaaaaaa
iiiiijijijijijiiiijijijiiiiijijijiiiaaaaaaaaaaaaaaaaaaaaaaaaaaaaaaaaaa
iiiiiiiiiiiiiiiiiiiiiiiiiiiiiiiiiiiiaaaaaaaaaaaaaaaaaaaaaaaaaaaaaaaaaa
"}
