"a" = (/turf/Grass,/area)
"b" = (/turf/water,/area)
"c" = (/obj/tree,/turf/Grass,/area)
"d" = (/obj/forest,/turf/Grass,/area)
"e" = (/obj/forest,/turf,/area)
"f" = (/turf/cobblestone,/area)
"g" = (/turf/bridge,/area)
"h" = (/turf/build/wall{dir = 9},/area)
"i" = (/turf/build/wall{dir = 1},/area)
"j" = (/turf/build/wall{dir = 5},/area)
"k" = (/turf/Grass,/area/safezone)
"l" = (/turf/build/wall{dir = 8},/area)
"m" = (/turf/cobblestone,/area/safezone)
"n" = (/turf/build/wall{dir = 4},/area)
"o" = (/turf/build/town{Cityname = "Tashkent"},/area/safezone)
"p" = (/mob/Player{cavalry = 500; infantry = 400},/turf/Grass,/area)
"q" = (/mob/Player,/turf/Grass,/area)
"r" = (/turf/build/wall{dir = 8},/area{dir = 8})
"s" = (/turf/build/wall{dir = 10},/area)
"t" = (/turf/build/wall,/area)
"u" = (/turf/build/wall{dir = 6},/area)

(1,1,1) = {"
aaaaaaaaaaaaaaaaaaaaabbbaaaaaaaaaaaaaaaaaaaaaaacccccdddddddddddddddddddddddddddddddddddddddddddddddd
aaaaaaaaaaaaaaaabbbbbababaaaabaaaaabbaaaaaaaaaaaaccccddddddddddddddddddddddddddddddddddddddddddddddd
aaaaaaaaaaaaabbbbbbbabababbbbabbbaabbaaaaaaaaaaaaccccddddddddddddddddddddddddddddddddddddddddddddddd
aaaaaaaaaaabbbbbbbbccbbbbbabbbbbbbbbbaaaaaaaaaaaaaccccdddddddddddddddddddddddddddddddddddddddddddddd
aaaaaaaaabbbbbeeeeeecbbccbbcbbbbbbbbbbaaaaaaaaaccccccccddddddddddddddddddddddddddddddddddddddddddddd
aaaaaabbbbbbeeebbbbbeeeeeeeccbbbbbbbbbbaaaaaaacccccccccddddddddddddddddddddddddddddddddddddddddddddd
aaaaabbbbbbeebbbbbbbbbbbbbbeeeccbbbbbaaaaaaaaacaccccccccdddddddddddddddddddddddddddddddddddddddddddd
aaaabbbbbaeefbbfbbbfbfbbbfbfffecbbbbaaaaaaaaaaccccccccccdddddddfffdddfddfddfffddfdfdfdfddddfdddddddd
aaaabbbbbaefbfbffbbfbffbffbfbbbecbbbbaaaaaaaaaaaacccccccdddddddfddfddfddfddfddfdfdfdddffdddfdddddddd
aaabbbbbaeefffbfbfbfbfbfbfbfffbecbbbbbaaaaaaaaaccccccccccddddddfddfddfddfddfddfdfdfdfdfdfddfdddddddd
aabbbbbbaeefbfbfbbffbfbbbfbbbfbecbbbbbaaaaaaacccccccccccccdddddfddfddfddfddfddfdfdfdfdfdfddfdddddddd
aabbbbbaacefbfbfbbbfbfbbbfbfffeccbbbbaaaaaaaccccccccccacccdddddfddfddfddfddfffddfdfdfdfddfdfdddddddd
abbbbbaaaceeebbbbbbbbbbbbbbbeeecbbbbbaaaaaaaccccccccaaaacccddddfddfddfddfddffdddfdfdfdfddfdfdddddddd
abbbbbaaaacceeeeebbbbbbbbbbeecbbbbbbaaaaaaaacccccccaaaaacccddddfddfddfddfddfdfddfdfdfdfdddffdddddddd
aabbbbaaaaaacccaeeeeeeeeeeeecbbbbbbbaaaaaaaaaccccccaaaaaccccdddfddfddfddfddfddfdfdfdfdfdddffdddddddd
aaabbbbaaaaaaaaaaccceeeecccbbbbbbbbaaaaaaaaaaaccccaaaaaaacccdddfffddddffdddfddfddfddfdfddddfdddddddd
aaabbbbbbaaaaaaabaaaaccbbbbbbbbbbbbaaaaaaaaaaaaaaaaaaaaaaacccddddddddddddddddddddddddddddddddddddddd
aaaabbbbbbbbaaaabbbbbbbbbbbbbbbbbbbaaaaaaaaaaaaaaaaaaaaaaaacccddddddddffddfffdfffdfdffffdfdddfdddddd
aaaabbbbbbbbbbbbbbbbbbbbbbbbbbbbbbbbaaaaaaaaaaaaaaaaaaaaaaaaccddddddddfdfdfdddfdddddfddddffddfdddddd
aaaabbbbbbbbbbbbbbbbbbbbbbbbbbbbbbbbbaaaaaaaaaaaaaaaaaaaaaaaccddddddddfdfdfffdfffdfdfdffdfdfdfdddddd
aaaabbbbbbbbbbbbbbbbbbbbbbbbbbbbbbbbbggbaaaaaaaaaaaaaaaaaaaaaccdddddddfdfdfdddddfdfdfddfdfddffdddddd
aaacccbbbbbbbbbbbbbbbbbbbbbbbbbbbbbbbggbbaaaaaaaaaaaaaaaaaaaacccddddddffddfffdfffdfdffffdfdddfdddddd
aaaaaccbbbbbbbbbaaaaaaabbbbbbbbbbbbbbggbbbaaaaaaaaaaaaaaaaaaaacccddddddddddddddddddddddddddddddddddd
aaaaaacccbbbbbaaaaaaaaaaaaaaaaaabbbbbggbbbaaaaaaaaaaaaaaaaaaaaacccdddddddddddddddddddddddddddddddddd
aaaaaaaaabbbbbaaaaaaaaaaaaaaaaaaaaaabggbbbbaaaaaaaaaaaaaaaaaaaaaccccdddddddddddddddddddddddddddddddd
aaaaaaaaaaaaaaaaaaaaaaaaaaaaaacccccaaaabbbbbaaaaaaaaaaaaaaaaaaaaaacccddddddddddddddddddddddddddddddd
aaaaaaaaaaaaaaaaaaaaaaaaaaaaaaacccccaaaabbbbaaaaaaaaaaaaaaaaaaaaaaaacccddddddddddddddddddddddddddddd
aaaaaaaaaaaaaaaaaaaaaaaaaaaaaaaaaaccccaabbbbbaaaaaaaaaaaaaaaaaaaaaacccccdddddddddddddddddddddddddddd
aaaaaaaaaaaaaaaaaaaaaaaaaaaaaaaaaaaacccaabbbbaaaaaaaaaaaaaaaaaaaaaaccccccddddddddddddddddddddddddddd
aaaaaaaaaaaaaaaaacccccccaaaaaaaaaaaaaccaabbbbaaaaaaaaaaaaaaaaaaaacccaaaccddddddddddddddddddddddddddd
aaaaaaaaaaaaaacccccccccccccaaaaaaaaaaaaaaabbbbaaaaaaaaaaaaaaaaaaccaaaaccccdddddddddddddddddddddddddd
aaaaaaaaaaaaacccdddddddddcccaaaaaaaaaaaaaabbbbbaaaaaaaaaaaaaaacccaaaaccccddddddddddddddddddddddddddd
aaaaaaaaaaaacccddddddddddcccaaaaaaaaaaaaaaabbbbbaaaaaaaaaaaaacccaaaaccccdddddddddddddddddddddddddddd
aaaaaaaaaacccddddddcccccccccccaaaaaaaaaaaaaaabbbbaaaaaaaaaaacccaaaaaccdddddddddddddddddddddddddddddd
aaaaaaaaaccccdddddcccccccccccccccaaabaaaaaaaaabbbbaaaaaaaaaaccaacccccddddddddddddddddddddddddddddddd
aaaaaaaaccccddddddddcccccdddccccccaabbaaaaaaaabbbbbabbbbccaccccccccccddddddddddddddddddddddddddddddd
aaaaaacccdddddddddddddcccccddddcccaabbbbaabbbbbbbbbbbaaacccccacccccddddddddddddddddddddddddddddddddd
aaaaaccdddddddccccddddddcccccdddcccaabbbbbbbbbbbbaaaaaaaaccccccccccddddddddddddddddddddddddddddddddd
aaaaacddddddcccaaccdddddddccccddcccaaaabbbbbccaaaaaaaaaaaccccccccddddddddddddddddddddddddddddddddddd
aaaaccdddddcccaaaaccdddddddccccddcccaaaabbbbcaaaaacccaaaaccccccccddddddddddddddddddddddddddddddddddd
aaaacccdddccaaaaaaacdddcdddccccddcccaaaaabbccaaaaacccaaaaacccccccddddddddddddddddddddddddddddddddddd
aaaacccccccaaaaaaaacccccaaaaccdddcccaaaaaabbccaaacccaaaaaaccccdddddddddddddddddddddddddddddddddddddd
aaaccccccaaaaaaaaaaddddcccccccdddcccaaaaaaabbcbbacccaaaaaacccddddddddddddddddddddddddddddddddddddddd
aacccddccaaaaaaaaaadddddddddddddcccaaaaaaaaabcbbaaccaaaaaacccddddddddddddddddddddddddddddddddddddddd
aacccddccaaaaaaaaacccddddddddddccccaaaaaaaabbbbaaaaaaaaaaacddddddddddddddddddddddddddddddddddddddddd
aacccddccaaaaaaaaaaccdddddddddcccaaaaaaaaabbbbaaaaaaaaaccccddddddddddddddddddddddddddddddddddddddddd
aaccdddccccaaaaaaacccddddddccccaaaaaaaaaabbbbcaaaaaaaaccccdddddddddddddddddddddddddddddddddddddddddd
aaccdddccccccccccccccdddccccaaaaaaaaaaaabbbccaaaaaaacccccdddddddddddddddddddcccddddddddddddddddddddd
aaccddddccccccccccccdddccccacaaaaaaaaaabbbbcaaaaaaaaaccccddddddddddddddddddccccccddddddddddddddddddd
aaccdddddddccccddccddddccccccaaaaaaaaaabbbcaaaaaaaaaaacccdddddddddddddddddccaaacccdddddddddddddddddd
aaccdddddddcdddddccddddcccccaaaaaaaaaabbbbaaaaaaaaaaaaacccdddddddddddddddccaaaaacccddddddddddddddddd
aaccdddddddcdddddccddddccccaaaaaaccaabbbbaaaaaaaaaaaaaaacccddddddddddddcccaaacaaaccddddddddddddddddd
aaaccdddcccccccccccccccccccaaaaacccaabbbaaaaaaaaaaaaaaaaaaccccdddddcccccaaacccaaacccdddddddddddddddd
aaaaccccccccccccccccccccccaaaaaccccaabbbaaaaaaacccccaaaaaaaaccccccccccccaaaccaaaaaacccdddddddddddddd
aaaaacccccccccccccccccccccaaaaacccaaagggaaaaaaaccddcaaccaaaaacccccccaaaaaaaaaaaaaaaacccccddddddddddd
aaaaaaacccccccccccccccccccaaaaaaaaaaagggaaaaaaaaccccacccccaaaaaaaaccaaaaaaaacccccaaaaccccddddddddddd
aaaaaaaaaaaaaaacccccccaaaaaaaaaaaaaaabbbaaaaaaaaacaacccccaaaaaaaaaaaaaaaaaacccccccaaaacccccddddddddd
aaaaaaaaaaaaaaaaaaaaaaaaaaaaaaaaaaaabbbaaaaaaaaaaaaaccccccccaaaaaaaaaaaaaaaccccccaaaaaaccccccddddddd
aaaaaaaaaaaaaaaaaaaaaaaaaaaaaaaaaaaabbaaaaaaaaaaaaaaaccccccccccccaaaaaaaaaaaccccaaaaaaacccccccdddddd
aaaaaaaaaaaaaaaaaaaaaaaaaaaaaaaaaaabbaaaaabaaaabbbaabaccccccccccccaaaaaaaaaaaaaaaaaaaaaaacccccccdddd
aaaaaaaaaaaaaaaaaaaaaaaaaaaaaaaaaaabbaaabbbbggbbbbbbbbaaaaacccccccaaaaaaaaaaaaaaaaaaaaaaaaccccccccdd
aaaaaaaaaaaaaaaaaaaaaaaaaaaaaaaaaabbbbbbbbbbggbbbbbbbbbbbbaaaaaaaaaaaaaaaaaaaaaaaaaaaaaacccccccccccc
aaaaaaaaaaaaaaaaaaaaaaaaaaaaaaabbbbbbbbbbbbbggbbbbbbbbbbbbbaaaaaaaaaaaaaaaaaaaaaaaaaaaaaaaaccccccccc
aaaaaaaabbaaaaaaaaaaaaabbaaaaabbbbbbbaaabbbaaaaaabbbbbbbbbbbaaaaaaaaaaaaaaaaaaaaaaaaaaaaaaaaaaaaaaaa
aaaaaaabbbbabbbaaabggbbbbbaabbbbbbaaaaaaaaaaaaaaaaaaaabbbbbbaaaaaaaaaaaaaaaaaaaaaaaaaaaaaaaaaaaaaaaa
aaaaaabbbbbbbbbbbbbggbbbbbbbbbbbaaaaaaaaaaaaaaaaaaaaaaabbbbbbaaaaaaaaaaaaaaaaaaaaaaaaaaaaaaaaaaaaaaa
bggbbbbbbbbbbbbbbbbggbbbbbbbbbbbbbaaaaaaaaaaaaaaaaaaaaaabbbbbbaaaaaaaaaaaaaaaaaaaaaaaaaaaaaaaaaaaaaa
bggbbbbbbbbbbbbbbbbggbbbbbbbbbbbbbbaaaaaaaaaaaaaaaaaaaaaabbbbbaaaaaaaaaaaaaaaaaaaaaaaaaabbbbbbbbbaaa
bggbbbbbbbbbbbbbbbbggbbbbbbbbbbbbbbbaaaaaaaaaaaaaaaaaaaaaabbbbbaaaaaaaaaaaaaaaaaaaaaabbbbbbbbbbbaaaa
bggbbbbbbbbbbbbbbbbggbbbbbbbbbbbbbbbbaaaaaaaaaaaaaaaaaaaaabbbbbbaaaaaaaaaaaaaaaabbbbbbbbbbbbbaaaaaaa
aaabbbbaaaaaabbbbbaaaabbbabbbbbbbbbbbbaaaaaaaaaaaaaaaaaaaaabbbbbbaaaaaaaaaaaabbbbbbbbbbaaaaaaaaaaaaa
aaaaaaaaaaaaaaaaaaaaaaabaaaabbbbbbbbbbaaaaaaaaaaaaaaaaaaaaaabbbbbbbbbaaaabbbbbbbbbbaaaaaaaaaaaaaaaaa
aaaaaaaaaaaaaaaaaaaaaaaaaaaaaaabbbbbbbbaaaaaaaaaaaaaaaaaaaaaabbbbbbbbbbbbbbbbbbbbbaaaaaaaaaaaaaaaaaa
aaaaaaaaaaaaaaaaaaaaaaaaaaaaaaaabbbbbbbbaaaaaaaaaaaaaaaaaaaaaaaabbbbbbbbbbbbbbaaaaaaaaaaaaaaaaaaaaaa
aaaaaaaaacccccccaccaaaaaaaaaaaaaaabbbbbbbaaaaaaaaaaaaaaaaaaaaaaaaaabbbbbbbbbaaaaaaaaaaaaaaaaaaaaaaaa
aaacccaccccccccccccccaaaaaaaaaaaaaabbbbbbbaaaaaaaaaaaaaaaaaaaaaaaaaaaaaaaaaaaaaaaaaaaaaaaaaaaaaaaaaa
ccccccccccccccccccccccccacaccaaaaaaabbbbbbbaaaaaaaaaaaaaaaaaaaaaaaaaaaaaaaaaaaaaaaaaaaaaaaaaaaaaaaaa
cccccccccccccccccccccccccccccaaaaaaaabbbbbbaaaaaaaaaaaaaaaaaaaaaaaaaaaaaaaaaaaaaaaaaaaaaaaaaaaaaaaaa
cccccccccccddddccccccccccccccccaaaaaaabbbbbbaaaaaaaaaaaaaaaaaaaaaaaaaaaaaaaaaaaaaaaaaaaaaaaaaaaaaaaa
ccccccdddddddddddddcccccccccccccaaaaaaabbbbbaaaaaaaaaaaaaaaaaaaaaaaaaaaaaaaaaaaaaaaaaaaaaaaaaaaaaaaa
ccddddddddddddddddddccccccccccccccaaaaabbbbbbaaaaaaaaaaaaaaaaaaaaaaaaaaaaaaaaaaaaaaaaaaaaaaaaaaaaaaa
ddddddddddddddddddddddddddddddcccccaaaaabbbbbaaaaaaaaaaaaaaaaaaaaaaaaaaaaaaaaaaaaaaaaaaaaaaaaaaaaaaa
dddddddddddddddddddddddddddddddcccccaaaaabbbbaaaaaaaaaaaaaaaaaaaaaaaaaaaaaaaaaaaaaaaaaaaaaaaaaaaaaaa
dddddddddddddddddddddddddddddddccccccaaaabbbbbaaaaaaaaaaaaaaaaaaaaaaaaaaaaaaaaaaaaaaaaaaaaaaaaaaaaaa
ddddddddddddddddddddddddddddddcccccccaaaaabbbbbaaaaaaaaaaaaaaaaaaaaaaaaaaaaaaaaaaaaaaaaaaaaaaaaaaaaa
ddddddddddddddddddddddddddddcccccccaaaaaaaabbbbaaaaaaaaaaaaaaaaaaaaaaaaaaaaaaaaaaaaaaaaaaaaaaaaaaaaa
ddddddccccccddddddddddddddccccccccccaaaaaaabbbbbaaaaaaaaaaaaaaaaaaaaaaaaaaaaaaaaaaaaaaaaaaaaaaaaaaaa
dddddccccccccccdddccddddddcccccddccccaaaaaabbbbbaaaaaaaaaaaaaaaaaaaaaaaaaaaaaaaaaaaaaaaaaaaaaaaaaaaa
dddddccccccccccccccccccdddccccdddddcccaaaaabbbbbaaaaaaaaaaaaaaaaaaaaaaaaaaaaaaaaaaaaaaaaaaaaaaaaaaaa
dddccccccccccccccccccccccccccccddddccccaaaaabbbbaaaaaaaaaaaaaaaaaaaaaaaaaaaaaaaaaaaaaaaaaaaaaaaaaaaa
dddcccaaccccccccccccccccccccccccddddcccaaaaabbbbaaaaaaaaaaaaaaaaaaaaaaaaaaaaaaaaaaaaaaaaaaaaaaaaaaaa
dddccaaaacccccacccccccccccaaaccccdddcccaaaaabbbbaaaaaaaaaaaaaaaaaaaaaaaaaaaaaaaaaaaaaaaaaaaaaaaaaaaa
ccccaaaaaaaccaaacccccccccaaaaacccdddcccaaaaaabbbbaaaaaaaaaaaaaaaaaaaaaaaaaaaaaaaaaaaaaaaaaaaaaaaaaaa
ccaaaaaaaaaccaaccccccccaaaaaaacccdccccaaaaaaagbggaaaaaaaaaaaaaaaaaaaaaaaaaaaaaaaaaaaaaaaaaaaaaaaaaaa
caahiiiiiijkaaaccccaccaaaaaaaaacccccccaaaaaaagbggaaaaaaaaaaaaaaaaaaaaaaaaaaaaaaaaaaaaaaaaaaaaaaaaaaa
aaalmmmmmmnkaaaaacaaaaaaaaaaaaaacccccaaaaaaabbbbbaaaaaaaaaaaaaaaaaaaaaaaaaaaaaaaaaaaaaaaaaaaaaaaaaaa
aaalmommmmmkaaaaaaaaaaaaaaaaapaaacccaaaaaaabbbbbbaaaaaaaaaaaaaaaaaaaaaaaaaaaaaaaaaaaaaaaaaaaaaaaaaaa
aaalmmmmmmmkaaaaaaaaaaqaaaaaaaaaaaaaaaaaaaabbbbbaaaaaaaaaaaaaaaaaaaaaaaaaaaaaaaaaaaaaaaaaaaaaaaaaaaa
aaarmmmmmmnkaaaaaaaaaaaaaaaaaaaaaaaaaaaaaabbbbbaaaaaaaaaaaaaaaaaaaaaaaaaaaaaaaaaaaaaaaaaaaaaaaaaaaaa
aaasttttttukaaaaaaaaaaaaaaaaaaaaaaaaaaaaabbbbbaaaaaaaaaaaaaaaaaaaaaaaaaaaaaaaaaaaaaaaaaaaaaaaaaaaaaa
"}
