"a" = (/turf/Grass,/area)
"b" = (/turf/water,/area)
"c" = (/turf/tree,/area)
"d" = (/turf/forest,/area)
"e" = (/obj/soldiers/free_infantry,/turf/tree,/area)
"f" = (/turf/cobblestone,/area)
"g" = (/obj/soldiers/free_cavalry,/turf/tree,/area)
"h" = (/obj/soldiers/free_cavalry,/turf/Grass,/area)
"i" = (/obj/soldiers/free_infantry,/turf/Grass,/area)
"j" = (/turf/bridge,/area)
"k" = (/turf/tree,/area/forest)
"l" = (/turf/forest,/area/forest)
"m" = (/turf/build/wall{dir = 9},/area)
"n" = (/turf/build/wall{dir = 1},/area)
"o" = (/turf/build/wall{dir = 5},/area)
"p" = (/turf/build/wall{dir = 8},/area)
"q" = (/turf/build/wall{dir = 4},/area)
"r" = (/mob/Player,/turf/Grass,/area)
"s" = (/turf/build/townhall,/area)
"t" = (/mob/Player{cavalry = 500; infantry = 400},/turf/Grass,/area)
"u" = (/turf/build/wall{dir = 8},/area{dir = 8})
"v" = (/turf/build/wall{dir = 10},/area)
"w" = (/turf/build/wall,/area)
"x" = (/turf/build/wall{dir = 6},/area)

(1,1,1) = {"
aaaaaaaaaaaaaaaaaaaaabbbaaaaaaaaaaaaaaaaaaaaaaacccccdddddddddddddddddddddddddddddddddddddddddddddddd
aaaaaaaaaaaaaaaabbbbbababaaaabaaaaabbaaaaaaaaaaaaccccddddddddddddddddddddddddddddddddddddddddddddddd
aaaaaaaaaaaaabbbbbbbabababbbbabbbaabbaaaaaaaaaaaaccccddddddddddddddddddddddddddddddddddddddddddddddd
aaaaaaaaaaabbbbbbbbcebbbbbabbbbbbbbbbaaaaaaaaaaaaaccccdddddddddddddddddddddddddddddddddddddddddddddd
aaaaaaaaabbbbbddddddcbbccbbcbbbbbbbbbbaaaaaaaaaccccecccddddddddddddddddddddddddddddddddddddddddddddd
aaaaaabbbbbbdddbbbbbdddddddccbbbbbbbbbbaaaaaaacccccccccddddddddddddddddddddddddddddddddddddddddddddd
aaaaabbbbbbddbbbbbbbbbbbbbbdddccbbbbbaaaaaaaaacaccccccccdddddddddddddddddddddddddddddddddddddddddddd
aaaabbbbbaddfbbfbbbfbfbbbfbfffdcbbbbaaaaaaaaaacccccgccccdddddddfffdddfddfddfffddfdfdfdfddddfdddddddd
aaaabbbbbadfbfbffbbfbffbffbfbbbdcbbbbaaaaaaaaaaaacccccccdddddddfddfddfddfddfddfdfdfdddffdddfdddddddd
aaabbbbbaddfffbfbfbfbfbfbfbfffbdcbbbbbaaaaaaaaaccccccccecddddddfddfddfddfddfddfdfdfdfdfdfddfdddddddd
aabbbbbbaddfbfbfbbffbfbbbfbbbfbdcbbbbbaaaaaaacccccccccccccdddddfddfddfddfddfddfdfdfdfdfdfddfdddddddd
aabbbbbaacdfbfbfbbbfbfbbbfbfffdccbbbbaaaaaaaccccceccccacccdddddfddfddfddfddfffddfdfdfdfddfdfdddddddd
abbbbbaaacdddbbbbbbbbbbbbbbbdddcbbbbbaaaaaaaccccccccaaaacccddddfddfddfddfddffdddfdfdfdfddfdfdddddddd
abbbbbahaiccdddddbbbbbbbbbbddcbbbbbbaaaaaaaacccccccaaaaacccddddfddfddfddfddfdfddfdfdfdfdddffdddddddd
aabbbbaaaaaacccaddddddddddddcbbbbbbbaaaaaaaaaccccccaaaaaccccdddfddfddfddfddfddfdfdfdfdfdddffdddddddd
aaabbbbaaaahaaaaacccddddgccbbbbbbbbaaaaaaaaaaaccccaaaaaaacccdddfffddddffdddfddfddfddfdfddddfdddddddd
aaabbbbbbaaaaaaabaaaaccbbbbbbbbbbbbaaaaaaaaaaaaaaaaaaaaaaacccddddddddddddddddddddddddddddddddddddddd
aaaabbbbbbbbaaaabbbbbbbbbbbbbbbbbbbaaaaaaaaaaaaaaaaaaaaaaaacccddddddddffddfffdfffdfdffffdfdddfdddddd
aaaabbbbbbbbbbbbbbbbbbbbbbbbbbbbbbbbaaaaaaaaaaaaaaaaaaaaaaaaceddddddddfdfdfdddfdddddfddddffddfdddddd
aaaabbbbbbbbbbbbbbbbbbbbbbbbbbbbbbbbbaaaaaaaaaaaaaaaaaaaaaaaccddddddddfdfdfffdfffdfdfdffdfdfdfdddddd
aaaabbbbbbbbbbbbbbbbbbbbbbbbbbbbbbbbbjjbaaaaaaaaaaaaaaaaaaaaaccdddddddfdfdfdddddfdfdfddfdfddffdddddd
aaacecbbbbbbbbbbbbbbbbbbbbbbbbbbbbbbbjjbbaaaaaaaaaaaaaaaaaaaaccgddddddffddfffdfffdfdffffdfdddfdddddd
aaaaaccbbbbbbbbbaaaaaaabbbbbbbbbbbbbbjjbbbaaaaaaaaaaaaaaaaaaaacccddddddddddddddddddddddddddddddddddd
aaaaaacccbbbbbaaaaaaaaaaaaaaaaaabbbbbjjbbbaaaaaaaaaaaaaaaaaaaaacccdddddddddddddddddddddddddddddddddd
aaaaaaaaabbbbbaaaaaaaaaaaaaaaaaaaaaabjjbbbbaaaaaaaaaaaaaaaaaaaaaccccdddddddddddddddddddddddddddddddd
aaaaaaaaaaaaaaaaaaaaaaaaaaaaaacccccaaaabbbbbaaaaaaaaaaaaaaaaaaaaaacccddddddddddddddddddddddddddddddd
aaaaaaaaaaaaaaaaaaaaaaaaaaaaaaacccccaaaabbbbaaaaaaaaaaaaaaaaaaaaaaaacceddddddddddddddddddddddddddddd
aaaaaaaaaaaaaaaaaaaaaaaaaaaaaaaaaaccccaabbbbbaaaaaaaaaaaaaaaaaaaaaacccccdddddddddddddddddddddddddddd
aaaaaaaaaaaaaaaaaaaaaaaaaaaaaaaaaaaacccaabbbbaaaaaaaaaaaaaaaaaaaaaaccccccddddddddddddddddddddddddddd
aaaaaaaaaaaaaaaaacccccccaaaaaaaaaaaaaccaabbbbaaaaaaaaaaaaaaaaaaaacccaaaccddddddddddddddddddddddddddd
aaaaaaaaaaaaaacccccccccccccaaaaaaaaaaaaaaabbbbaaaaaaaaaaaaaaaaaaccaaaaccccdddddddddddddddddddddddddd
aaaaaaaaaaaaacccdddddddddcccaaaaaaaaaaaaaabbbbbaaaaaaaaaaaaaaacccaaaaccceddddddddddddddddddddddddddd
aaaaaaaaaaaacceddddddddddcccaaaaaaaaaaaaaaabbbbbaaaaaaaaaaaaacccaaaaccccdddddddddddddddddddddddddddd
aaaaaaaaaacccddddddcecccccccccaaaaaaaaaaaaaaabbbbaaaaaaaaaaacccaaaaaccdddddddddddddddddddddddddddddd
aaaaaaaaaccccdddddcccccccccccccccaaabaaaaaaaaabbbbaaaaaaaaaaccaacccccddddddddddddddddddddddddddddddd
aaaaaaaaccccddddddddcccccdddccccccaabbaaaaaaaabbbbbabbbbccaccccccccccddddddddddddddddddddddddddddddd
aaaaaacccdddddddddddddcccccddddcccaabbbbaabbbbbbbbbbbaaacccccacccccddddddddddddddddddddddddddddddddd
aaaaaccdddddddccccddddddcccccdddcccaabbbbbbbbbbbbaaaaaaaaccccccecccddddddddddddddddddddddddddddddddd
aaaaacddddddcccaaccdddddddccccddcccaaaabbbbbccaaaaaaaaaaaccccccccddddddddddddddddddddddddddddddddddd
aaaaccdddddcccaaaaccdddddddccccddcccaaaabbbbcaaaaacccaaaaccccecccddddddddddddddddddddddddddddddddddd
aaaacgcdddcciaaaaaacdddcdddccccddcccaaaaabbccaaaaacccaaaaacccccccddddddddddddddddddddddddddddddddddd
aaaacccccccaiaaaaaacccccaaiaccdddcccaaaaaabbccaaacccaaaaaaccccdddddddddddddddddddddddddddddddddddddd
aaaccccccaaaaaaaaahddddcccccccdddcccaaaaaaabbcbbacccaaaaaacccddddddddddddddddddddddddddddddddddddddd
aacgcddccaaaaaaaahadddddddddddddcccaaaaaaaaabcbbaaccaaaaaacccddddddddddddddddddddddddddddddddddddddd
aacccddccaaaaaaaaacccddddddddddccccaaaaaaaabbbbaaaaaaaaaaacddddddddddddddddddddddddddddddddddddddddd
aacecddccaaiaahaaahccdddddddddcccaaaaaaaaabbbbaaaaaaaaaccccddddddddddddddddddddddddddddddddddddddddd
aaccdddccccaaaaaaacccddddddccccaaaaaaaaaabbbbcaaaaaaaaccccdddddddddddddddddddddddddddddddddddddddddd
aaccdddccccccccccccccdddccccaaaaaaaaaaaabbbccaaaaaaacccccdddddddddddddddddddcecddddddddddddddddddddd
aaccddddccccccccccccdddccccacaaaaaaaaaabbbbcaaaaaaaaaccccddddddddddddddddddccccccddddddddddddddddddd
aaccdddddddccccddccddddecccccaaaaaaaaaabbbcaaaaaaaaaaacccdddddddddddddddddccaaacccdddddddddddddddddd
aaccdddddddcdddddccddddcccccaaaaaaaaaabbbbaaaaaaaaaaaaacccdddddddddddddddccaaaaacccddddddddddddddddd
aaccdddddddcdddddccddddccccaaaaaaccaabbbbaaaaaaaaaaaaaaacccddddddddddddcccaaacaaaccddddddddddddddddd
aaaccdddccccgccccccccccccccaaaaacccaabbbaaaaaaaaaaaaaaaaaaccccdddddcccccaaacccaaacccdddddddddddddddd
aaaaccccccccccccccccccccccaaaaaccccaabbbaaaaaaacccccaaaaaaaaccccecccccccaaaccaaaaaacccdddddddddddddd
aaaaaccccccccccccgccccccccaaaaacccaaajjjaaaaaaaccddcaaccaaaaacccccccaaaaaaaaaaaaaaaacccccddddddddddd
aaaaaaacccccccccccccccccccaaaaaaaaaaajjjaaaaaaaaccccacccccaaaaaaaaccaaaaaaaacccccaaaaccccddddddddddd
aaaaaaaaaaaaaaacccccccaaaaaaaaaaaaaaabbbaaaaaaaaacaacceccaaaaaaaaaaaaaaaaaacccccccaaaacccccddddddddd
aaaaaaaaaaaaaaaaaaaaaaaaaaaaaaaaaaaabbbaaaaaaaaaaaaaccccccccaaaaaaaaaaaaaaaccceccaaaaaaccceccddddddd
aaaaaaaaaaaaaaaaaaaaaaaaaaaaaaaaaaaabbaaaaaaaaaaaaaaaccceccccccccaaaaaaaaaaaccccaaaaaaacccccccdddddd
aaaaaaaaaaaaaaaaaaaaaaaaaaaaaaaaaaabbaaaaabaaaabbbaabaccccccccecccaaaaaaaaaaaaaaaaaaaaaaacccceccdddd
aaaaaaaaaaaaaaaaaaaaaaaaaaaaaaaaaaabbaaabbbbjjbbbbbbbbaaaaacccccccaaaaaaaaaaaaaaaaaaaaaaaaccccccccdd
aaaaaaaaaaaaaaaaaaaaaaaaaaaaaaaaaabbbbbbbbbbjjbbbbbbbbbbbbaaaaaaaaaaaaaaaaaaaaaaaaaaaaaacccccccccecc
aaaaaaaaaaaaaaaaaaaaaaaaaaaaaaabbbbbbbbbbbbbjjbbbbbbbbbbbbbaaaaaaaaaaaaaaaaaaaaaaaaaaaaaaaaccccccccc
aaaaaaaabbaaaaaaaaaaaaabbaaaaabbbbbbbaaabbbaaaaaabbbbbbbbbbbaaaaaaaaaaaaaaaaaaaaaaaaaaaaaaaaaaaaaaaa
aaaaaaabbbbabbbaaabjjbbbbbaabbbbbbaaaaaaaaaaaaaaaaaaaabbbbbbaaaaaaaaaaaaaaaaaaaaaaaaaaaaaaaaaaaaaaaa
aaaaaabbbbbbbbbbbbbjjbbbbbbbbbbbaaaaaaaaaaaaaaaaaaaaaaabbbbbbaaaaaaaaaaaaaaaaaaaaaaaaaaaaaaaaaaaaaaa
bjjbbbbbbbbbbbbbbbbjjbbbbbbbbbbbbbaaaaaaaaaaaaaaaaaaaaaabbbbbbaaaaaaaaaaaaaaaaaaaaaaaaaaaaaaaaaaaaaa
bjjbbbbbbbbbbbbbbbbjjbbbbbbbbbbbbbbaaaaaaaaaaaaaaaaaaaaaabbbbbaaaaaaaaaaaaaaaaaaaaaaaaaabbbbbbbbbaaa
bjjbbbbbbbbbbbbbbbbjjbbbbbbbbbbbbbbbaaaaaaaaaaaaaaaaaaaaaabbbbbaaaaaaaaaaaaaaaaaaaaaabbbbbbbbbbbaaaa
bjjbbbbbbbbbbbbbbbbjjbbbbbbbbbbbbbbbbaaaaaaaaaaaaaaaaaaaaabbbbbbaaaaaaaaaaaaaaaabbbbbbbbbbbbbaaaaaaa
aaabbbbaaaaaabbbbbaaaabbbabbbbbbbbbbbbaaaaaaaaaaaaaaaaaaaaabbbbbbaaaaaaaaaaaabbbbbbbbbbaaaaaaaaaaaaa
aaaaaaaaaaaaaaaaaaaaaaabaaaabbbbbbbbbbaaaaaaaaaaaaaaaaaaaaaabbbbbbbbbaaaabbbbbbbbbbaaaaaaaaaaaaaaaaa
aaaaaaaaaaaaaaaaaaaaaaaaaaaaaaabbbbbbbbaaaaaaaaaaaaaaaaaaaaaabbbbbbbbbbbbbbbbbbbbbaaaaaaaaaaaaaaaaaa
aaaaaaaaaaaaaaaaaaaaaaaaaaaaaaaabbbbbbbbaaaaaaaaaaaaaaaaaaaaaaaabbbbbbbbbbbbbbaaaaaaaaaaaaaaaaaaaaaa
aaaaaaaaakkkkkkkakkaaaaaaaaaaaaaaabbbbbbbaaaaaaaaaaaaaaaaaaaaaaaaaabbbbbbbbbaaaaaaaaaaaaaaaaaaaaaaaa
aaakkkakkkkkkkkkkkkkkaaaaaaaaaaaaaabbbbbbbaaaaaaaaaaaaaaaaaaaaaaaaaaaaaaaaaaaaaaaaaaaaaaaaaaaaaaaaaa
kkkkkkkkkkkkkkkkkkkkkkkkakakkaaaaaaabbbbbbbaaaaaaaaaaaaaaaaaaaaaaaaaaaaaaaaaaaaaaaaaaaaaaaaaaaaaaaaa
kkkkkkkkkkkkkkkkkkkkkkkkkkkkkaaaaaaaabbbbbbaaaaaaaaaaaaaaaaaaaaaaaaaaaaaaaaaaaaaaaaaaaaaaaaaaaaaaaaa
kkkkkkkkkkkllllkkkkkkkkkkkkkkkkaaaaaaabbbbbbaaaaaaaaaaaaaaaaaaaaaaaaaaaaaaaaaaaaaaaaaaaaaaaaaaaaaaaa
kkkkkklllllllllllllkkkkkkkkkkkkcaaaaaaabbbbbaaaaaaaaaaaaaaaaaaaaaaaaaaaaaaaaaaaaaaaaaaaaaaaaaaaaaaaa
kkllllllllllllllllllkkkkkkkkkkkkkkaaaaabbbbbbaaaaaaaaaaaaaaaaaaaaaaaaaaaaaaaaaaaaaaaaaaaaaaaaaaaaaaa
llllllllllllllllllllllllllldddckkkkaaaaabbbbbaaaaaaaaaaaaaaaaaaaaaaaaaaaaaaaaaaaaaaaaaaaaaaaaaaaaaaa
llllllllllllllllllllllllllldlllkkkkkaaaaabbbbaaaaaaaaaaaaaaaaaaaaaaaaaaaaaaaaaaaaaaaaaaaaaaaaaaaaaaa
ddddddddddddddddddddddddddlllllkkkkkkaaaabbbbbaaaaaaaaaaaaaaaaaaaaaaaaaaaaaaaaaaaaaaaaaaaaaaaaaaaaaa
ddddddddddddddddddddddllllllllkkkkkkkaaaaabbbbbaaaaaaaaaaaaaaaaaaaaaaaaaaaaaaaaaaaaaaaaaaaaaaaaaaaaa
ddddddddddddddddddddddllllllkkkkkkcaaaaaaaabbbbaaaaaaaaaaaaaaaaaaaaaaaaaaaaaaaaaaaaaaaaaaaaaaaaaaaaa
ddddddkkkkkkddddddddddllllkkkkkkkcccaaaaaaabbbbbaaaaaaaaaaaaaaaaaaaaaaaaaaaaaaaaaaaaaaaaaaaaaaaaaaaa
dddddkkkkkkkkkkddlkkldllllkkkkkddccccaaaaaabbbbbaaaaaaaaaaaaaaaaaaaaaaaaaaaaaaaaaaaaaaaaaaaaaaaaaaaa
dddddkkkkkkkkkkkkkkkkkklllkkkcdddddcccaaaaabbbbbaaaaaaaaaaaaaaaaaaaaaaaaaaaaaaaaaaaaaaaaaaaaaaaaaaaa
dddkkkkkkkkkkkkkkkkkkkkkkkkkkccddddccccaaaaabbbbaaaaaaaaaaaaaaaaaaaaaaaaaaaaaaaaaaaaaaaaaaaaaaaaaaaa
dddkkkaakkkkkkkkkkkkkkkkkkkkccccddddcccaaaaabbbbaaaaaaaaaaaaaaaaaaaaaaaaaaaaaaaaaaaaaaaaaaaaaaaaaaaa
dddkkaaaakkkkkakkkkkkkkkkkaaaccccdddcccaaaaabbbbaaaaaaaaaaaaaaaaaaaaaaaaaaaaaaaaaaaaaaaaaaaaaaaaaaaa
kkkkaaaaaaakkaaakkkccckkkaaaaacccdddcccaaaaaabbbbaaaaaaaaaaaaaaaaaaaaaaaaaaaaaaaaaaaaaaaaaaaaaaaaaaa
kkaaaaaaaaakkaakkkkkkkkaaaaaaacccdccccaaaaaaajbjjaaaaaaaaaaaaaaaaaaaaaaaaaaaaaaaaaaaaaaaaaaaaaaaaaaa
kaamnnnnnnoaaaakkkkakkaaaaaaaaacccccccaaaaaaajbjjaaaaaaaaaaaaaaaaaaaaaaaaaaaaaaaaaaaaaaaaaaaaaaaaaaa
aaapffffffqaaaiaakaraaahaaaaaaaacccccaaaaaaabbbbbaaaaaaaaaaaaaaaaaaaaaaaaaaaaaaaaaaaaaaaaaaaaaaaaaaa
aaapfsfffffaaaaaiaaahaaaaaaaataaacccaaaaaaabbbbbbaaaaaaaaaaaaaaaaaaaaaaaaaaaaaaaaaaaaaaaaaaaaaaaaaaa
aaapfffffffaaaaaaaaaaaaaaaaaaaaaaaaaaaaaaaabbbbbaaaaaaaaaaaaaaaaaaaaaaaaaaaaaaaaaaaaaaaaaaaaaaaaaaaa
aaauffffffqaaaaaaaaaaaaaaaaaaaaaaaaaaaaaaabbbbbaaaaaaaaaaaaaaaaaaaaaaaaaaaaaaaaaaaaaaaaaaaaaaaaaaaaa
aaavwwwwwwxaaaaaaaaaaaaaaaaaaaaaaaaaaaaaabbbbbaaaaaaaaaaaaaaaaaaaaaaaaaaaaaaaaaaaaaaaaaaaaaaaaaaaaaa
"}
